"Localidades";"Períodos";"População ";"População Masculina ";"População Feminina ";"Razão de Sexos ";"População Urbana ";"População Rural ";"Grau de Urbanização (Em %)";"Cód. IBGE"
"Adamantina";"2020";"33894";"16326";"17568";"92,93";"32668";"1226";"96,38";3500105
"Adolfo";"2020";"3447";"1707";"1740";"98,1";"3189";"258";"92,52";3500204
"Aguaí";"2020";"35608";"17889";"17719";"100,96";"32833";"2775";"92,21";3500303
"Águas da Prata";"2020";"7797";"3830";"3967";"96,55";"7188";"609";"92,19";3500402
"Águas de Lindóia";"2020";"18374";"8944";"9430";"94,85";"18209";"165";"99,1";3500501
"Águas de Santa Bárbara";"2020";"5931";"2903";"3028";"95,87";"4611";"1320";"77,74";3500550
"Águas de São Pedro";"2020";"3122";"1466";"1656";"88,53";"3122";"-";"100";3500600
"Agudos";"2020";"36134";"17816";"18318";"97,26";"34815";"1319";"96,35";3500709
"Alambari";"2020";"5779";"2885";"2894";"99,69";"4729";"1050";"81,83";3500758
"Alfredo Marcondes";"2020";"3927";"2001";"1926";"103,89";"3554";"373";"90,5";3500808
"Altair";"2020";"4036";"2142";"1894";"113,09";"3413";"623";"84,56";3500907
"Altinópolis";"2020";"15553";"7735";"7818";"98,94";"14272";"1281";"91,76";3501004
"Alto Alegre";"2020";"4017";"2052";"1965";"104,43";"3412";"605";"84,94";3501103
"Alumínio";"2020";"17972";"9023";"8949";"100,83";"15073";"2899";"83,87";3501152
"Álvares Florence";"2020";"3621";"1832";"1789";"102,4";"2663";"958";"73,54";3501202
"Álvares Machado";"2020";"23789";"11684";"12105";"96,52";"21720";"2069";"91,3";3501301
"Álvaro de Carvalho";"2020";"5044";"3142";"1902";"165,19";"3400";"1644";"67,41";3501400
"Alvinlândia";"2020";"3176";"1566";"1610";"97,27";"2929";"247";"92,22";3501509
"Americana";"2020";"233458";"114164";"119294";"95,7";"232367";"1091";"99,53";3501608
"Américo Brasiliense";"2020";"40243";"20106";"20137";"99,85";"39938";"305";"99,24";3501707
"Américo de Campos";"2020";"5736";"2865";"2871";"99,79";"5025";"711";"87,6";3501806
"Amparo";"2020";"69639";"34189";"35450";"96,44";"58620";"11019";"84,18";3501905
"Analândia";"2020";"4850";"2475";"2375";"104,21";"4065";"785";"83,81";3502002
"Andradina";"2020";"56054";"27443";"28611";"95,92";"52856";"3198";"94,29";3502101
"Angatuba";"2020";"24501";"12302";"12199";"100,84";"18333";"6168";"74,83";3502200
"Anhembi";"2020";"6672";"3398";"3274";"103,79";"5256";"1416";"78,78";3502309
"Anhumas";"2020";"3963";"1971";"1992";"98,95";"3477";"486";"87,74";3502408
"Aparecida";"2020";"35709";"17187";"18522";"92,79";"35190";"519";"98,55";3502507
"Aparecida d'Oeste";"2020";"4132";"2001";"2131";"93,9";"3589";"543";"86,86";3502606
"Apiaí";"2020";"24666";"12298";"12368";"99,43";"19995";"4671";"81,06";3502705
"Aramina";"2020";"5496";"2741";"2755";"99,49";"5293";"203";"96,31";3503000
"Arandu";"2020";"6165";"3099";"3066";"101,08";"5087";"1078";"82,51";3503109
"Arapeí";"2020";"2471";"1234";"1237";"99,76";"1920";"551";"77,7";3503158
"Araraquara";"2020";"227618";"109815";"117803";"93,22";"221147";"6471";"97,16";3503208
"Araras";"2020";"131057";"64375";"66682";"96,54";"124772";"6285";"95,2";3503307
"Araçariguama";"2020";"20980";"10611";"10369";"102,33";"20980";"-";"100";3502754
"Araçatuba";"2020";"190469";"91360";"99109";"92,18";"186796";"3673";"98,07";3502804
"Araçoiaba da Serra";"2020";"32390";"16012";"16378";"97,77";"22263";"10127";"68,73";3502903
"Arco-Íris";"2020";"1816";"906";"910";"99,56";"1165";"651";"64,15";3503356
"Arealva";"2020";"8196";"4121";"4075";"101,13";"6875";"1321";"83,88";3503406
"Areias";"2020";"3843";"1901";"1942";"97,89";"2577";"1266";"67,06";3503505
"Areiópolis";"2020";"10857";"5558";"5299";"104,89";"10062";"795";"92,68";3503604
"Ariranha";"2020";"9320";"4714";"4606";"102,34";"8826";"494";"94,7";3503703
"Artur Nogueira";"2020";"52609";"26120";"26489";"98,61";"47632";"4977";"90,54";3503802
"Arujá";"2020";"89744";"44246";"45498";"97,25";"86429";"3315";"96,31";3503901
"Aspásia";"2020";"1765";"882";"883";"99,89";"1322";"443";"74,9";3503950
"Assis";"2020";"101381";"49365";"52016";"94,9";"96956";"4425";"95,64";3504008
"Atibaia";"2020";"139606";"68437";"71169";"96,16";"130756";"8850";"93,66";3504107
"Auriflama";"2020";"14471";"7181";"7290";"98,5";"13517";"954";"93,41";3504206
"Avaí";"2020";"5288";"2643";"2645";"99,92";"3551";"1737";"67,15";3504305
"Avanhandava";"2020";"12114";"6637";"5477";"121,18";"10243";"1871";"84,56";3504404
"Avaré";"2020";"87538";"43336";"44202";"98,04";"84509";"3029";"96,54";3504503
"Bady Bassitt";"2020";"16329";"8109";"8220";"98,65";"15333";"996";"93,9";3504602
"Balbinos";"2020";"3704";"2978";"726";"410,19";"1191";"2513";"32,15";3504701
"Bálsamo";"2020";"8524";"4150";"4374";"94,88";"7948";"576";"93,24";3504800
"Bananal";"2020";"10651";"5251";"5400";"97,24";"8994";"1657";"84,44";3504909
"Barão de Antonina";"2020";"3383";"1710";"1673";"102,21";"2156";"1227";"63,73";3505005
"Barbosa";"2020";"7284";"3651";"3633";"100,5";"6230";"1054";"85,53";3505104
"Bariri";"2020";"33993";"16944";"17049";"99,38";"32762";"1231";"96,38";3505203
"Barra Bonita";"2020";"34914";"17011";"17903";"95,02";"34268";"646";"98,15";3505302
"Barra do Chapéu";"2020";"5530";"2886";"2644";"109,15";"1628";"3902";"29,44";3505351
"Barra do Turvo";"2020";"7687";"3971";"3716";"106,86";"3591";"4096";"46,72";3505401
"Barretos";"2020";"118048";"57086";"60962";"93,64";"114452";"3596";"96,95";3505500
"Barrinha";"2020";"32338";"16190";"16148";"100,26";"31979";"359";"98,89";3505609
"Barueri";"2020";"264390";"128627";"135763";"94,74";"264390";"-";"100";3505708
"Bastos";"2020";"20301";"9916";"10385";"95,48";"18001";"2300";"88,67";3505807
"Batatais";"2020";"60222";"29529";"30693";"96,21";"53258";"6964";"88,44";3505906
"Bauru";"2020";"364225";"176473";"187752";"93,99";"358133";"6092";"98,33";3506003
"Bebedouro";"2020";"74155";"36025";"38130";"94,48";"71307";"2848";"96,16";3506102
"Bento de Abreu";"2020";"2945";"1489";"1456";"102,27";"2815";"130";"95,59";3506201
"Bernardino de Campos";"2020";"10787";"5243";"5544";"94,57";"9869";"918";"91,49";3506300
"Bertioga";"2020";"63290";"31408";"31882";"98,51";"62695";"595";"99,06";3506359
"Bilac";"2020";"7816";"3849";"3967";"97,03";"7373";"443";"94,33";3506409
"Birigui";"2020";"121329";"58965";"62364";"94,55";"118125";"3204";"97,36";3506508
"Biritiba Mirim";"2020";"32338";"16227";"16111";"100,72";"28210";"4128";"87,23";3506607
"Boa Esperança do Sul";"2020";"14582";"7283";"7299";"99,78";"13403";"1179";"91,91";3506706
"Bocaina";"2020";"12135";"6022";"6113";"98,51";"11341";"794";"93,46";3506805
"Bofete";"2020";"11076";"5568";"5508";"101,09";"7062";"4014";"63,76";3506904
"Boituva";"2020";"57292";"28670";"28622";"100,17";"53893";"3399";"94,07";3507001
"Bom Jesus dos Perdões";"2020";"24291";"12127";"12164";"99,7";"22118";"2173";"91,05";3507100
"Bom Sucesso de Itararé";"2020";"3861";"1944";"1917";"101,41";"2885";"976";"74,72";3507159
"Borá";"2020";"812";"422";"390";"108,21";"632";"180";"77,83";3507209
"Boracéia";"2020";"4759";"2417";"2342";"103,2";"4342";"417";"91,24";3507308
"Borborema";"2020";"15323";"7707";"7616";"101,19";"14405";"918";"94,01";3507407
"Borebi";"2020";"2579";"1272";"1307";"97,32";"2400";"179";"93,06";3507456
"Botucatu";"2020";"141135";"68579";"72556";"94,52";"136396";"4739";"96,64";3507506
"Bragança Paulista";"2020";"163980";"80417";"83563";"96,24";"160871";"3109";"98,1";3507605
"Braúna";"2020";"5552";"2786";"2766";"100,72";"5150";"402";"92,76";3507704
"Brejo Alegre";"2020";"2768";"1408";"1360";"103,53";"2378";"390";"85,91";3507753
"Brodowski";"2020";"23943";"11785";"12158";"96,93";"23647";"296";"98,76";3507803
"Brotas";"2020";"23850";"11820";"12030";"98,25";"20735";"3115";"86,94";3507902
"Buri";"2020";"19678";"9979";"9699";"102,89";"16462";"3216";"83,66";3508009
"Buritama";"2020";"16596";"8263";"8333";"99,16";"15922";"674";"95,94";3508108
"Buritizal";"2020";"4307";"2191";"2116";"103,54";"3611";"696";"83,84";3508207
"Cabrália Paulista";"2020";"4308";"2177";"2131";"102,16";"3760";"548";"87,28";3508306
"Cabreúva";"2020";"49430";"24837";"24593";"100,99";"44288";"5142";"89,6";3508405
"Cachoeira Paulista";"2020";"32231";"15736";"16495";"95,4";"26907";"5324";"83,48";3508603
"Caconde";"2020";"18854";"9370";"9484";"98,8";"13537";"5317";"71,8";3508702
"Cafelândia";"2020";"17244";"8485";"8759";"96,87";"15529";"1715";"90,05";3508801
"Caiabu";"2020";"4103";"2103";"2000";"105,15";"3506";"597";"85,45";3508900
"Caieiras";"2020";"100612";"49282";"51330";"96,01";"98864";"1748";"98,26";3509007
"Caiuá";"2020";"5600";"2893";"2707";"106,87";"2145";"3455";"38,3";3509106
"Cajamar";"2020";"77627";"38646";"38981";"99,14";"76714";"913";"98,82";3509205
"Cajati";"2020";"28992";"14590";"14402";"101,31";"21499";"7493";"74,15";3509254
"Cajobi";"2020";"10105";"5137";"4968";"103,4";"9594";"511";"94,94";3509304
"Cajuru";"2020";"25663";"12784";"12879";"99,26";"22937";"2726";"89,38";3509403
"Campina do Monte Alegre";"2020";"5812";"2929";"2883";"101,6";"5120";"692";"88,09";3509452
"Campinas";"2020";"1175501";"567233";"608268";"93,25";"1155288";"20213";"98,28";3509502
"Campo Limpo Paulista";"2020";"82842";"40611";"42231";"96,16";"82842";"-";"100";3509601
"Campos do Jordão";"2020";"50118";"24371";"25747";"94,66";"49805";"313";"99,38";3509700
"Campos Novos Paulista";"2020";"4817";"2464";"2353";"104,72";"3981";"836";"82,64";3509809
"Cananéia";"2020";"12341";"6144";"6197";"99,14";"10710";"1631";"86,78";3509908
"Canas";"2020";"5064";"2543";"2521";"100,87";"4870";"194";"96,17";3509957
"Cândido Mota";"2020";"30019";"14693";"15326";"95,87";"28537";"1482";"95,06";3510005
"Cândido Rodrigues";"2020";"2674";"1306";"1368";"95,47";"2286";"388";"85,49";3510104
"Canitar";"2020";"4991";"2516";"2475";"101,66";"4766";"225";"95,49";3510153
"Capão Bonito";"2020";"46418";"23054";"23364";"98,67";"39459";"6959";"85,01";3510203
"Capela do Alto";"2020";"20542";"10517";"10025";"104,91";"17817";"2725";"86,73";3510302
"Capivari";"2020";"54231";"27079";"27152";"99,73";"52908";"1323";"97,56";3510401
"Caraguatatuba";"2020";"116106";"56984";"59122";"96,38";"111793";"4313";"96,29";3510500
"Carapicuíba";"2020";"394598";"191655";"202943";"94,44";"394598";"-";"100";3510609
"Cardoso";"2020";"11721";"5736";"5985";"95,84";"10781";"940";"91,98";3510708
"Casa Branca";"2020";"29462";"15444";"14018";"110,17";"24404";"5058";"82,83";3510807
"Cássia dos Coqueiros";"2020";"2495";"1266";"1229";"103,01";"1916";"579";"76,79";3510906
"Castilho";"2020";"20728";"10256";"10472";"97,94";"15642";"5086";"75,46";3511003
"Catanduva";"2020";"117206";"56874";"60332";"94,27";"116265";"941";"99,2";3511102
"Catiguá";"2020";"7529";"3802";"3727";"102,01";"7010";"519";"93,11";3511201
"Caçapava";"2020";"91217";"45040";"46177";"97,54";"78049";"13168";"85,56";3508504
"Cedral";"2020";"8836";"4384";"4452";"98,47";"7326";"1510";"82,91";3511300
"Cerqueira César";"2020";"19213";"9455";"9758";"96,89";"17718";"1495";"92,22";3511409
"Cerquilho";"2020";"46411";"22942";"23469";"97,75";"44009";"2402";"94,82";3511508
"Cesário Lange";"2020";"17248";"8905";"8343";"106,74";"11645";"5603";"67,52";3511607
"Charqueada";"2020";"16933";"8574";"8359";"102,57";"15491";"1442";"91,48";3511706
"Chavantes";"2020";"12223";"6055";"6168";"98,17";"11525";"698";"94,29";3557204
"Clementina";"2020";"8324";"4293";"4031";"106,5";"8066";"258";"96,9";3511904
"Colina";"2020";"17603";"8660";"8943";"96,84";"16781";"822";"95,33";3512001
"Colômbia";"2020";"6046";"3052";"2994";"101,94";"4541";"1505";"75,11";3512100
"Conchal";"2020";"27284";"13716";"13568";"101,09";"26382";"902";"96,69";3512209
"Conchas";"2020";"17134";"8552";"8582";"99,65";"14628";"2506";"85,37";3512308
"Cordeirópolis";"2020";"24356";"12216";"12140";"100,63";"21876";"2480";"89,82";3512407
"Coroados";"2020";"5926";"2940";"2986";"98,46";"5081";"845";"85,74";3512506
"Coronel Macedo";"2020";"4843";"2463";"2380";"103,49";"3969";"874";"81,95";3512605
"Corumbataí";"2020";"3962";"1991";"1971";"101,01";"2475";"1487";"62,47";3512704
"Cosmópolis";"2020";"71282";"35411";"35871";"98,72";"66201";"5081";"92,87";3512803
"Cosmorama";"2020";"6997";"3489";"3508";"99,46";"5364";"1633";"76,66";3512902
"Cotia";"2020";"247424";"121053";"126371";"95,79";"247424";"-";"100";3513009
"Cravinhos";"2020";"34428";"17154";"17274";"99,31";"33919";"509";"98,52";3513108
"Cristais Paulista";"2020";"8425";"4265";"4160";"102,52";"6987";"1438";"82,93";3513207
"Cruzália";"2020";"2117";"1023";"1094";"93,51";"1508";"609";"71,23";3513306
"Cruzeiro";"2020";"79927";"38818";"41109";"94,43";"78112";"1815";"97,73";3513405
"Cubatão";"2020";"129145";"64116";"65029";"98,6";"129145";"-";"100";3513504
"Cunha";"2020";"21681";"10990";"10691";"102,8";"13609";"8072";"62,77";3513603
"Descalvado";"2020";"32430";"15933";"16497";"96,58";"30064";"2366";"92,7";3513702
"Diadema";"2020";"404477";"195649";"208828";"93,69";"404477";"-";"100";3513801
"Dirce Reis";"2020";"1717";"868";"849";"102,24";"1417";"300";"82,53";3513850
"Divinolândia";"2020";"10886";"5364";"5522";"97,14";"8192";"2694";"75,25";3513900
"Dobrada";"2020";"8904";"4569";"4335";"105,4";"8705";"199";"97,77";3514007
"Dois Córregos";"2020";"26972";"13477";"13495";"99,87";"26113";"859";"96,82";3514106
"Dolcinópolis";"2020";"2040";"1056";"984";"107,32";"1915";"125";"93,87";3514205
"Dourado";"2020";"8482";"4261";"4221";"100,95";"7778";"704";"91,7";3514304
"Dracena";"2020";"44995";"22124";"22871";"96,73";"41798";"3197";"92,89";3514403
"Duartina";"2020";"11975";"5788";"6187";"93,55";"11044";"931";"92,23";3514502
"Dumont";"2020";"9570";"4779";"4791";"99,75";"9392";"178";"98,14";3514601
"Echaporã";"2020";"6217";"3048";"3169";"96,18";"5145";"1072";"82,76";3514700
"Eldorado";"2020";"15236";"7693";"7543";"101,99";"7498";"7738";"49,21";3514809
"Elias Fausto";"2020";"17346";"8921";"8425";"105,89";"14606";"2740";"84,2";3514908
"Elisiário";"2020";"3499";"1817";"1682";"108,03";"3267";"232";"93,37";3514924
"Embaúba";"2020";"2409";"1246";"1163";"107,14";"2139";"270";"88,79";3514957
"Embu das Artes";"2020";"270790";"131608";"139182";"94,56";"270790";"-";"100";3515004
"Embu-Guaçu";"2020";"68053";"33656";"34397";"97,85";"66238";"1815";"97,33";3515103
"Emilianópolis";"2020";"3068";"1534";"1534";"100";"2692";"376";"87,74";3515129
"Engenheiro Coelho";"2020";"20535";"10661";"9874";"107,97";"15639";"4896";"76,16";3515152
"Espírito Santo do Pinhal";"2020";"42573";"20804";"21769";"95,57";"38837";"3736";"91,22";3515186
"Espírito Santo do Turvo";"2020";"4799";"2395";"2404";"99,63";"4105";"694";"85,54";3515194
"Estiva Gerbi";"2020";"11079";"5523";"5556";"99,41";"8837";"2242";"79,76";3557303
"Estrela d'Oeste";"2020";"8094";"4056";"4038";"100,45";"7059";"1035";"87,21";3515202
"Estrela do Norte";"2020";"2665";"1357";"1308";"103,75";"2307";"358";"86,57";3515301
"Euclides da Cunha Paulista";"2020";"9537";"4753";"4784";"99,35";"6155";"3382";"64,54";3515350
"Fartura";"2020";"15644";"7550";"8094";"93,28";"13045";"2599";"83,39";3515400
"Fernando Prestes";"2020";"5572";"2716";"2856";"95,1";"5043";"529";"90,51";3515608
"Fernandópolis";"2020";"66112";"32060";"34052";"94,15";"64087";"2025";"96,94";3515509
"Fernão";"2020";"1649";"828";"821";"100,85";"1009";"640";"61,19";3515657
"Ferraz de Vasconcelos";"2020";"193037";"94280";"98757";"95,47";"184375";"8662";"95,51";3515707
"Flora Rica";"2020";"1589";"787";"802";"98,13";"1386";"203";"87,22";3515806
"Floreal";"2020";"2856";"1401";"1455";"96,29";"2420";"436";"84,73";3515905
"Flórida Paulista";"2020";"12120";"6637";"5483";"121,05";"9563";"2557";"78,9";3516002
"Florínea";"2020";"2703";"1307";"1396";"93,62";"2475";"228";"91,56";3516101
"Franca";"2020";"342125";"167238";"174887";"95,63";"336119";"6006";"98,24";3516200
"Francisco Morato";"2020";"174403";"86341";"88062";"98,05";"174048";"355";"99,8";3516309
"Franco da Rocha";"2020";"152201";"77456";"74745";"103,63";"140219";"11982";"92,13";3516408
"Gabriel Monteiro";"2020";"2684";"1344";"1340";"100,3";"2386";"298";"88,9";3516507
"Gália";"2020";"6563";"3248";"3315";"97,98";"5089";"1474";"77,54";3516606
"Garça";"2020";"42483";"20622";"21861";"94,33";"39806";"2677";"93,7";3516705
"Gastão Vidigal";"2020";"4768";"2588";"2180";"118,72";"4473";"295";"93,81";3516804
"Gavião Peixoto";"2020";"4610";"2362";"2248";"105,07";"4116";"494";"89,28";3516853
"General Salgado";"2020";"10648";"5286";"5362";"98,58";"9424";"1224";"88,5";3516903
"Getulina";"2020";"10847";"5887";"4960";"118,69";"8841";"2006";"81,51";3517000
"Glicério";"2020";"4749";"2361";"2388";"98,87";"3659";"1090";"77,05";3517109
"Guaimbê";"2020";"5534";"2735";"2799";"97,71";"5045";"489";"91,16";3517307
"Guaíra";"2020";"39061";"19247";"19814";"97,14";"37840";"1221";"96,87";3517406
"Guaiçara";"2020";"11947";"5981";"5966";"100,25";"11131";"816";"93,17";3517208
"Guapiara";"2020";"17775";"8983";"8792";"102,17";"7499";"10276";"42,19";3517604
"Guapiaçu";"2020";"20848";"10482";"10366";"101,12";"18942";"1906";"90,86";3517505
"Guará";"2020";"20824";"10335";"10489";"98,53";"20329";"495";"97,62";3517703
"Guaraci";"2020";"10978";"5565";"5413";"102,81";"10201";"777";"92,92";3517901
"Guarani d'Oeste";"2020";"1922";"939";"983";"95,52";"1718";"204";"89,39";3518008
"Guarantã";"2020";"6477";"3243";"3234";"100,28";"5882";"595";"90,81";3518107
"Guararapes";"2020";"32076";"15724";"16352";"96,16";"30158";"1918";"94,02";3518206
"Guararema";"2020";"29429";"14694";"14735";"99,72";"25325";"4104";"86,05";3518305
"Guaratinguetá";"2020";"118345";"56915";"61430";"92,65";"112868";"5477";"95,37";3518404
"Guaraçaí";"2020";"8412";"4140";"4272";"96,91";"6910";"1502";"82,14";3517802
"Guareí";"2020";"15750";"9448";"6302";"149,92";"9097";"6653";"57,76";3518503
"Guariba";"2020";"39021";"19563";"19458";"100,54";"38406";"615";"98,42";3518602
"Guarujá";"2020";"316405";"154134";"162271";"94,99";"316344";"61";"99,98";3518701
"Guarulhos";"2020";"1351275";"658363";"692912";"95,01";"1351275";"-";"100";3518800
"Guatapará";"2020";"7440";"3787";"3653";"103,67";"5982";"1458";"80,4";3518859
"Guzolândia";"2020";"5107";"2579";"2528";"102,02";"4550";"557";"89,09";3518909
"Herculândia";"2020";"9260";"4621";"4639";"99,61";"8671";"589";"93,64";3519006
"Holambra";"2020";"14493";"7329";"7164";"102,3";"12287";"2206";"84,78";3519055
"Hortolândia";"2020";"230268";"115703";"114565";"100,99";"230268";"-";"100";3519071
"Iacanga";"2020";"11306";"5782";"5524";"104,67";"10025";"1281";"88,67";3519105
"Iacri";"2020";"6272";"3168";"3104";"102,06";"5299";"973";"84,49";3519204
"Iaras";"2020";"6894";"4434";"2460";"180,24";"3067";"3827";"44,49";3519253
"Ibaté";"2020";"34738";"17709";"17029";"103,99";"33550";"1188";"96,58";3519303
"Ibirá";"2020";"12059";"5963";"6096";"97,82";"11269";"790";"93,45";3519402
"Ibirarema";"2020";"7509";"3759";"3750";"100,24";"7054";"455";"93,94";3519501
"Ibitinga";"2020";"58501";"28760";"29741";"96,7";"56607";"1894";"96,76";3519600
"Ibiúna";"2020";"76430";"38520";"37910";"101,61";"28199";"48231";"36,9";3519709
"Icém";"2020";"8032";"4075";"3957";"102,98";"6963";"1069";"86,69";3519808
"Iepê";"2020";"7921";"3887";"4034";"96,36";"7354";"567";"92,84";3519907
"Igarapava";"2020";"29456";"14549";"14907";"97,6";"28119";"1337";"95,46";3520103
"Igaratá";"2020";"9312";"4729";"4583";"103,19";"7971";"1341";"85,6";3520202
"Igaraçu do Tietê";"2020";"24135";"11976";"12159";"98,49";"23997";"138";"99,43";3520004
"Iguape";"2020";"29465";"14632";"14833";"98,64";"25834";"3631";"87,68";3520301
"Ilha Comprida";"2020";"10296";"5009";"5287";"94,74";"10296";"-";"100";3520426
"Ilha Solteira";"2020";"25748";"12426";"13322";"93,27";"24162";"1586";"93,84";3520442
"Ilhabela";"2020";"33470";"16864";"16606";"101,55";"33240";"230";"99,31";3520400
"Indaiatuba";"2020";"242868";"120227";"122641";"98,03";"240426";"2442";"98,99";3520509
"Indiana";"2020";"4775";"2388";"2387";"100,04";"4209";"566";"88,15";3520608
"Indiaporã";"2020";"3854";"1867";"1987";"93,96";"3491";"363";"90,58";3520707
"Inúbia Paulista";"2020";"3892";"1938";"1954";"99,18";"3527";"365";"90,62";3520806
"Ipaussu";"2020";"14506";"7278";"7228";"100,69";"13644";"862";"94,06";3520905
"Iperó";"2020";"34352";"18176";"16176";"112,36";"21197";"13155";"61,71";3521002
"Ipeúna";"2020";"7571";"3879";"3692";"105,07";"6860";"711";"90,61";3521101
"Ipiguá";"2020";"5231";"2631";"2600";"101,19";"3383";"1848";"64,67";3521150
"Iporanga";"2020";"4407";"2206";"2201";"100,23";"2894";"1513";"65,67";3521200
"Ipuã";"2020";"15861";"8022";"7839";"102,33";"15355";"506";"96,81";3521309
"Iracemápolis";"2020";"23654";"11787";"11867";"99,33";"23238";"416";"98,24";3521408
"Irapuã";"2020";"7734";"4010";"3724";"107,68";"7132";"602";"92,22";3521507
"Irapuru";"2020";"7334";"4255";"3079";"138,19";"5185";"2149";"70,7";3521606
"Itaberá";"2020";"17614";"8836";"8778";"100,66";"13379";"4235";"75,96";3521705
"Itaí";"2020";"26507";"13928";"12579";"110,72";"20814";"5693";"78,52";3521804
"Itajobi";"2020";"14614";"7308";"7306";"100,03";"12840";"1774";"87,86";3521903
"Itaju";"2020";"3654";"1891";"1763";"107,26";"2959";"695";"80,98";3522000
"Itanhaém";"2020";"98757";"47554";"51203";"92,87";"98018";"739";"99,25";3522109
"Itaoca";"2020";"3186";"1652";"1534";"107,69";"1737";"1449";"54,52";3522158
"Itapecerica da Serra";"2020";"169619";"84582";"85037";"99,46";"168213";"1406";"99,17";3522208
"Itapetininga";"2020";"160150";"79719";"80431";"99,11";"147379";"12771";"92,03";3522307
"Itapeva";"2020";"91693";"45170";"46523";"97,09";"83413";"8280";"90,97";3522406
"Itapevi";"2020";"237714";"116910";"120804";"96,78";"237714";"-";"100";3522505
"Itapira";"2020";"71500";"35231";"36269";"97,14";"67027";"4473";"93,74";3522604
"Itapirapuã Paulista";"2020";"4180";"2124";"2056";"103,31";"2146";"2034";"51,34";3522653
"Itápolis";"2020";"41548";"20493";"21055";"97,33";"38966";"2582";"93,79";3522703
"Itaporanga";"2020";"14688";"7300";"7388";"98,81";"11952";"2736";"81,37";3522802
"Itapuí";"2020";"13779";"6904";"6875";"100,42";"13369";"410";"97,02";3522901
"Itapura";"2020";"4916";"2510";"2406";"104,32";"3929";"987";"79,92";3523008
"Itaquaquecetuba";"2020";"370589";"182254";"188335";"96,77";"370589";"-";"100";3523107
"Itararé";"2020";"49018";"24010";"25008";"96,01";"45460";"3558";"92,74";3523206
"Itariri";"2020";"17274";"8637";"8637";"100";"12323";"4951";"71,34";3523305
"Itatiba";"2020";"117916";"58013";"59903";"96,84";"102739";"15177";"87,13";3523404
"Itatinga";"2020";"20550";"10443";"10107";"103,32";"19190";"1360";"93,38";3523503
"Itirapina";"2020";"17162";"9962";"7200";"138,36";"15873";"1289";"92,49";3523602
"Itirapuã";"2020";"6279";"3169";"3110";"101,9";"5425";"854";"86,4";3523701
"Itobi";"2020";"7609";"3891";"3718";"104,65";"7157";"452";"94,06";3523800
"Itu";"2020";"169772";"83649";"86123";"97,13";"161437";"8335";"95,09";3523909
"Itupeva";"2020";"59159";"29812";"29347";"101,58";"55279";"3880";"93,44";3524006
"Ituverava";"2020";"40246";"19573";"20673";"94,68";"37890";"2356";"94,15";3524105
"Jaborandi";"2020";"6677";"3351";"3326";"100,75";"6340";"337";"94,95";3524204
"Jaboticabal";"2020";"74221";"35999";"38222";"94,18";"72946";"1275";"98,28";3524303
"Jacareí";"2020";"227945";"111079";"116866";"95,05";"224797";"3148";"98,62";3524402
"Jaci";"2020";"6969";"3524";"3445";"102,29";"6371";"598";"91,42";3524501
"Jacupiranga";"2020";"17222";"8719";"8503";"102,54";"9377";"7845";"54,45";3524600
"Jaguariúna";"2020";"54848";"27057";"27791";"97,36";"53844";"1004";"98,17";3524709
"Jales";"2020";"47254";"22954";"24300";"94,46";"44467";"2787";"94,1";3524808
"Jambeiro";"2020";"6214";"3168";"3046";"104,01";"2975";"3239";"47,88";3524907
"Jandira";"2020";"123603";"60463";"63140";"95,76";"123603";"-";"100";3525003
"Jardinópolis";"2020";"42893";"21450";"21443";"100,03";"42070";"823";"98,08";3525102
"Jarinu";"2020";"29820";"14848";"14972";"99,17";"25692";"4128";"86,16";3525201
"Jaú";"2020";"147505";"71960";"75545";"95,25";"143891";"3614";"97,55";3525300
"Jeriquara";"2020";"3141";"1603";"1538";"104,23";"2733";"408";"87,01";3525409
"Joanópolis";"2020";"12666";"6336";"6330";"100,09";"12666";"-";"100";3525508
"João Ramalho";"2020";"4384";"2223";"2161";"102,87";"3903";"481";"89,03";3525607
"José Bonifácio";"2020";"35981";"17873";"18108";"98,7";"33223";"2758";"92,33";3525706
"Júlio Mesquita";"2020";"4640";"2255";"2385";"94,55";"4430";"210";"95,47";3525805
"Jumirim";"2020";"3306";"1695";"1611";"105,21";"2175";"1131";"65,79";3525854
"Jundiaí";"2020";"407016";"198688";"208328";"95,37";"395118";"11898";"97,08";3525904
"Junqueirópolis";"2020";"20065";"10511";"9554";"110,02";"17068";"2997";"85,06";3526001
"Juquiá";"2020";"18828";"9408";"9420";"99,87";"12310";"6518";"65,38";3526100
"Juquitiba";"2020";"30401";"15255";"15146";"100,72";"26087";"4314";"85,81";3526209
"Lagoinha";"2020";"4819";"2426";"2393";"101,38";"3421";"1398";"70,99";3526308
"Laranjal Paulista";"2020";"27834";"13687";"14147";"96,75";"25207";"2627";"90,56";3526407
"Lavínia";"2020";"8500";"5997";"2503";"239,59";"4148";"4352";"48,8";3526506
"Lavrinhas";"2020";"7167";"3584";"3583";"100,03";"6741";"426";"94,06";3526605
"Leme";"2020";"100975";"50369";"50606";"99,53";"99174";"1801";"98,22";3526704
"Lençóis Paulista";"2020";"66343";"32787";"33556";"97,71";"65168";"1175";"98,23";3526803
"Limeira";"2020";"296300";"145230";"151070";"96,13";"289378";"6922";"97,66";3526902
"Lindóia";"2020";"7722";"3802";"3920";"96,99";"7722";"-";"100";3527009
"Lins";"2020";"75087";"36425";"38662";"94,21";"74209";"878";"98,83";3527108
"Lorena";"2020";"86639";"41841";"44798";"93,4";"84522";"2117";"97,56";3527207
"Lourdes";"2020";"2182";"1132";"1050";"107,81";"1870";"312";"85,7";3527256
"Louveira";"2020";"48268";"24328";"23940";"101,62";"47122";"1146";"97,63";3527306
"Lucélia";"2020";"21019";"11029";"9990";"110,4";"18381";"2638";"87,45";3527405
"Lucianópolis";"2020";"2261";"1115";"1146";"97,29";"1843";"418";"81,51";3527504
"Luís Antônio";"2020";"14166";"7287";"6879";"105,93";"13961";"205";"98,55";3527603
"Luiziânia";"2020";"5754";"2970";"2784";"106,68";"5441";"313";"94,56";3527702
"Lupércio";"2020";"4421";"2140";"2281";"93,82";"4196";"225";"94,91";3527801
"Lutécia";"2020";"2621";"1297";"1324";"97,96";"2197";"424";"83,82";3527900
"Macatuba";"2020";"16932";"8465";"8467";"99,98";"16559";"373";"97,8";3528007
"Macaubal";"2020";"7749";"3881";"3868";"100,34";"7028";"721";"90,7";3528106
"Macedônia";"2020";"3574";"1771";"1803";"98,23";"2844";"730";"79,57";3528205
"Magda";"2020";"3088";"1567";"1521";"103,02";"2641";"447";"85,52";3528304
"Mairinque";"2020";"46323";"22945";"23378";"98,15";"37178";"9145";"80,26";3528403
"Mairiporã";"2020";"98622";"49481";"49141";"100,69";"90911";"7711";"92,18";3528502
"Manduri";"2020";"9525";"4721";"4804";"98,27";"8786";"739";"92,24";3528601
"Marabá Paulista";"2020";"4931";"3084";"1847";"166,97";"2195";"2736";"44,51";3528700
"Maracaí";"2020";"13521";"6705";"6816";"98,37";"12503";"1018";"92,47";3528809
"Marapoama";"2020";"2906";"1477";"1429";"103,36";"2617";"289";"90,06";3528858
"Mariápolis";"2020";"3975";"2027";"1948";"104,06";"3406";"569";"85,69";3528908
"Marília";"2020";"231554";"111671";"119883";"93,15";"221166";"10388";"95,51";3529005
"Marinópolis";"2020";"2097";"1058";"1039";"101,83";"1728";"369";"82,4";3529104
"Martinópolis";"2020";"25668";"13246";"12422";"106,63";"22310";"3358";"86,92";3529203
"Matão";"2020";"80020";"39430";"40590";"97,14";"78552";"1468";"98,17";3529302
"Mauá";"2020";"460132";"224753";"235379";"95,49";"460132";"-";"100";3529401
"Mendonça";"2020";"5043";"2538";"2505";"101,32";"4386";"657";"86,97";3529500
"Meridiano";"2020";"3739";"1805";"1934";"93,33";"2709";"1030";"72,45";3529609
"Mesópolis";"2020";"1893";"942";"951";"99,05";"1635";"258";"86,37";3529658
"Miguelópolis";"2020";"21424";"10633";"10791";"98,54";"20459";"965";"95,5";3529708
"Mineiros do Tietê";"2020";"12597";"6245";"6352";"98,32";"12034";"563";"95,53";3529807
"Mira Estrela";"2020";"2939";"1446";"1493";"96,85";"1960";"979";"66,69";3530003
"Miracatu";"2020";"19934";"9901";"10033";"98,68";"10767";"9167";"54,01";3529906
"Mirandópolis";"2020";"28646";"15534";"13112";"118,47";"26161";"2485";"91,33";3530102
"Mirante do Paranapanema";"2020";"17769";"8907";"8862";"100,51";"10463";"7306";"58,88";3530201
"Mirassol";"2020";"57824";"28358";"29466";"96,24";"56363";"1461";"97,47";3530300
"Mirassolândia";"2020";"4702";"2383";"2319";"102,76";"3823";"879";"81,31";3530409
"Mococa";"2020";"66753";"33085";"33668";"98,27";"63433";"3320";"95,03";3530508
"Mogi das Cruzes";"2020";"432905";"210668";"222237";"94,79";"401520";"31385";"92,75";3530607
"Mogi Guaçu";"2020";"148325";"73207";"75118";"97,46";"142302";"6023";"95,94";3530706
"Mogi Mirim";"2020";"90439";"44315";"46124";"96,08";"86584";"3855";"95,74";3530805
"Mombuca";"2020";"3332";"1683";"1649";"102,06";"2948";"384";"88,48";3530904
"Mongaguá";"2020";"54610";"26995";"27615";"97,75";"54372";"238";"99,56";3531100
"Monte Alegre do Sul";"2020";"7749";"3863";"3886";"99,41";"4827";"2922";"62,29";3531209
"Monte Alto";"2020";"48405";"23750";"24655";"96,33";"46900";"1505";"96,89";3531308
"Monte Aprazível";"2020";"23458";"11561";"11897";"97,18";"21781";"1677";"92,85";3531407
"Monte Azul Paulista";"2020";"18191";"9037";"9154";"98,72";"17350";"841";"95,38";3531506
"Monte Castelo";"2020";"3991";"1955";"2036";"96,02";"3336";"655";"83,59";3531605
"Monte Mor";"2020";"59614";"29636";"29978";"98,86";"56936";"2678";"95,51";3531803
"Monteiro Lobato";"2020";"4465";"2297";"2168";"105,95";"1983";"2482";"44,41";3531704
"Monções";"2020";"2175";"1104";"1071";"103,08";"1898";"277";"87,26";3531001
"Morro Agudo";"2020";"32332";"16421";"15911";"103,21";"31558";"774";"97,61";3531902
"Morungaba";"2020";"13247";"6601";"6646";"99,32";"11938";"1309";"90,12";3532009
"Motuca";"2020";"4638";"2327";"2311";"100,69";"3705";"933";"79,88";3532058
"Murutinga do Sul";"2020";"4281";"2110";"2171";"97,19";"2631";"1650";"61,46";3532108
"Nantes";"2020";"3071";"1528";"1543";"99,03";"2937";"134";"95,64";3532157
"Narandiba";"2020";"4841";"2435";"2406";"101,21";"3935";"906";"81,28";3532207
"Natividade da Serra";"2020";"6698";"3437";"3261";"105,4";"2844";"3854";"42,46";3532306
"Nazaré Paulista";"2020";"18445";"9396";"9049";"103,83";"17810";"635";"96,56";3532405
"Neves Paulista";"2020";"8620";"4252";"4368";"97,34";"7932";"688";"92,02";3532504
"Nhandeara";"2020";"10782";"5266";"5516";"95,47";"9057";"1725";"84";3532603
"Nipoã";"2020";"4969";"2594";"2375";"109,22";"4510";"459";"90,76";3532702
"Nova Aliança";"2020";"6450";"3186";"3264";"97,61";"5635";"815";"87,36";3532801
"Nova Campina";"2020";"9675";"4904";"4771";"102,79";"7671";"2004";"79,29";3532827
"Nova Canaã Paulista";"2020";"1937";"977";"960";"101,77";"979";"958";"50,54";3532843
"Nova Castilho";"2020";"1176";"573";"603";"95,02";"938";"238";"79,76";3532868
"Nova Europa";"2020";"10749";"5300";"5449";"97,27";"10204";"545";"94,93";3532900
"Nova Granada";"2020";"20918";"10503";"10415";"100,84";"19592";"1326";"93,66";3533007
"Nova Guataporanga";"2020";"2191";"1091";"1100";"99,18";"1969";"222";"89,87";3533106
"Nova Independência";"2020";"3731";"1847";"1884";"98,04";"3172";"559";"85,02";3533205
"Nova Luzitânia";"2020";"4044";"2106";"1938";"108,67";"3782";"262";"93,52";3533304
"Nova Odessa";"2020";"58039";"28687";"29352";"97,73";"57093";"946";"98,37";3533403
"Novais";"2020";"5509";"2931";"2578";"113,69";"5137";"372";"93,25";3533254
"Novo Horizonte";"2020";"38954";"19364";"19590";"98,85";"36529";"2425";"93,77";3533502
"Nuporanga";"2020";"7268";"3616";"3652";"99,01";"6926";"342";"95,29";3533601
"Ocauçu";"2020";"4146";"2095";"2051";"102,15";"3582";"564";"86,4";3533700
"Óleo";"2020";"2527";"1250";"1277";"97,89";"1818";"709";"71,94";3533809
"Olímpia";"2020";"52516";"25803";"26713";"96,59";"50148";"2368";"95,49";3533908
"Onda Verde";"2020";"4225";"2154";"2071";"104,01";"3597";"628";"85,14";3534005
"Oriente";"2020";"6265";"3048";"3217";"94,75";"5956";"309";"95,07";3534104
"Orindiúva";"2020";"6866";"3465";"3401";"101,88";"6405";"461";"93,29";3534203
"Orlândia";"2020";"42266";"20687";"21579";"95,87";"41177";"1089";"97,42";3534302
"Osasco";"2020";"680964";"327774";"353190";"92,8";"680964";"-";"100";3534401
"Oscar Bressane";"2020";"2514";"1204";"1310";"91,91";"2203";"311";"87,63";3534500
"Osvaldo Cruz";"2020";"31263";"15573";"15690";"99,25";"28537";"2726";"91,28";3534609
"Ourinhos";"2020";"110489";"53580";"56909";"94,15";"107635";"2854";"97,42";3534708
"Ouro Verde";"2020";"8268";"4069";"4199";"96,9";"7784";"484";"94,15";3534807
"Ouroeste";"2020";"9777";"4832";"4945";"97,71";"9111";"666";"93,19";3534757
"Pacaembu";"2020";"13056";"7602";"5454";"139,38";"9620";"3436";"73,68";3534906
"Palestina";"2020";"12160";"6119";"6041";"101,29";"10458";"1702";"86";3535002
"Palmares Paulista";"2020";"12997";"6881";"6116";"112,51";"12623";"374";"97,12";3535101
"Palmeira d'Oeste";"2020";"9130";"4535";"4595";"98,69";"7428";"1702";"81,36";3535200
"Palmital";"2020";"21599";"10512";"11087";"94,81";"20431";"1168";"94,59";3535309
"Panorama";"2020";"15199";"7550";"7649";"98,71";"14870";"329";"97,84";3535408
"Paraguaçu Paulista";"2020";"44180";"22105";"22075";"100,14";"40038";"4142";"90,62";3535507
"Paraibuna";"2020";"18230";"9161";"9069";"101,01";"5496";"12734";"30,15";3535606
"Paraíso";"2020";"6269";"3185";"3084";"103,27";"5706";"563";"91,02";3535705
"Paranapanema";"2020";"19962";"10081";"9881";"102,02";"17183";"2779";"86,08";3535804
"Paranapuã";"2020";"3892";"1979";"1913";"103,45";"3568";"324";"91,68";3535903
"Parapuã";"2020";"10507";"5312";"5195";"102,25";"9053";"1454";"86,16";3536000
"Pardinho";"2020";"6392";"3224";"3168";"101,77";"5657";"735";"88,5";3536109
"Pariquera-Açu";"2020";"19251";"9473";"9778";"96,88";"13610";"5641";"70,7";3536208
"Parisi";"2020";"2054";"1038";"1016";"102,17";"1719";"335";"83,69";3536257
"Patrocínio Paulista";"2020";"14463";"7278";"7185";"101,29";"12307";"2156";"85,09";3536307
"Paulicéia";"2020";"7146";"3671";"3475";"105,64";"6368";"778";"89,11";3536406
"Paulínia";"2020";"105037";"51851";"53186";"97,49";"104940";"97";"99,91";3536505
"Paulistânia";"2020";"1769";"906";"863";"104,98";"1379";"390";"77,95";3536570
"Paulo de Faria";"2020";"8521";"4261";"4260";"100,02";"7814";"707";"91,7";3536604
"Pederneiras";"2020";"45570";"22709";"22861";"99,34";"42380";"3190";"93";3536703
"Pedra Bela";"2020";"5964";"3091";"2873";"107,59";"1711";"4253";"28,69";3536802
"Pedranópolis";"2020";"2422";"1243";"1179";"105,43";"1548";"874";"63,91";3536901
"Pedregulho";"2020";"16279";"8210";"8069";"101,75";"12172";"4107";"74,77";3537008
"Pedreira";"2020";"46548";"22986";"23562";"97,56";"46157";"391";"99,16";3537107
"Pedrinhas Paulista";"2020";"3010";"1489";"1521";"97,9";"2621";"389";"87,08";3537156
"Pedro de Toledo";"2020";"10977";"5471";"5506";"99,36";"7759";"3218";"70,68";3537206
"Penápolis";"2020";"60774";"29560";"31214";"94,7";"58877";"1897";"96,88";3537305
"Pereira Barreto";"2020";"25391";"12404";"12987";"95,51";"23775";"1616";"93,64";3537404
"Pereiras";"2020";"8428";"4264";"4164";"102,4";"5628";"2800";"66,78";3537503
"Peruíbe";"2020";"66201";"32104";"34097";"94,15";"65798";"403";"99,39";3537602
"Piacatu";"2020";"5891";"2946";"2945";"100,03";"5422";"469";"92,04";3537701
"Piedade";"2020";"53536";"27027";"26509";"101,95";"25239";"28297";"47,14";3537800
"Pilar do Sul";"2020";"28221";"14235";"13986";"101,78";"23491";"4730";"83,24";3537909
"Pindamonhangaba";"2020";"163611";"80289";"83322";"96,36";"159147";"4464";"97,27";3538006
"Pindorama";"2020";"16255";"8239";"8016";"102,78";"15386";"869";"94,65";3538105
"Pinhalzinho";"2020";"14755";"7340";"7415";"98,99";"7429";"7326";"50,35";3538204
"Piquerobi";"2020";"3535";"1722";"1813";"94,98";"2818";"717";"79,72";3538303
"Piquete";"2020";"13647";"6602";"7045";"93,71";"12804";"843";"93,82";3538501
"Piracaia";"2020";"26287";"12996";"13291";"97,78";"26287";"-";"100";3538600
"Piracicaba";"2020";"389873";"190456";"199417";"95,51";"382790";"7083";"98,18";3538709
"Piraju";"2020";"28574";"13836";"14738";"93,88";"26324";"2250";"92,13";3538808
"Pirajuí";"2020";"23259";"12689";"10570";"120,05";"19075";"4184";"82,01";3538907
"Pirangi";"2020";"10823";"5430";"5393";"100,69";"9951";"872";"91,94";3539004
"Pirapora do Bom Jesus";"2020";"18851";"9287";"9564";"97,1";"18851";"-";"100";3539103
"Pirapozinho";"2020";"27213";"13276";"13937";"95,26";"26103";"1110";"95,92";3539202
"Pirassununga";"2020";"73706";"35937";"37769";"95,15";"69037";"4669";"93,67";3539301
"Piratininga";"2020";"13213";"6514";"6699";"97,24";"11570";"1643";"87,57";3539400
"Pitangueiras";"2020";"38584";"19562";"19022";"102,84";"37614";"970";"97,49";3539509
"Planalto";"2020";"5167";"2660";"2507";"106,1";"4585";"582";"88,74";3539608
"Platina";"2020";"3501";"1805";"1696";"106,43";"2894";"607";"82,66";3539707
"Poá";"2020";"115538";"56096";"59442";"94,37";"113713";"1825";"98,42";3539806
"Poloni";"2020";"5667";"2788";"2879";"96,84";"5044";"623";"89,01";3539905
"Pompéia";"2020";"21282";"10429";"10853";"96,09";"19954";"1328";"93,76";3540002
"Pongaí";"2020";"3351";"1691";"1660";"101,87";"2951";"400";"88,06";3540101
"Pontal";"2020";"49283";"25970";"23313";"111,4";"48784";"499";"98,99";3540200
"Pontalinda";"2020";"4487";"2346";"2141";"109,57";"3929";"558";"87,56";3540259
"Pontes Gestal";"2020";"2528";"1239";"1289";"96,12";"2249";"279";"88,96";3540309
"Populina";"2020";"3995";"1990";"2005";"99,25";"3351";"644";"83,88";3540408
"Porangaba";"2020";"9310";"4712";"4598";"102,48";"4495";"4815";"48,28";3540507
"Porto Feliz";"2020";"51697";"25817";"25880";"99,76";"45016";"6681";"87,08";3540606
"Porto Ferreira";"2020";"54102";"26691";"27411";"97,37";"53132";"970";"98,21";3540705
"Potim";"2020";"20702";"11555";"9147";"126,33";"15699";"5003";"75,83";3540754
"Potirendaba";"2020";"16605";"8409";"8196";"102,6";"15278";"1327";"92,01";3540804
"Pracinha";"2020";"2913";"2094";"819";"255,68";"1395";"1518";"47,89";3540853
"Pradópolis";"2020";"20907";"10593";"10314";"102,71";"19502";"1405";"93,28";3540903
"Praia Grande";"2020";"316844";"152091";"164753";"92,31";"316844";"-";"100";3541000
"Pratânia";"2020";"5156";"2651";"2505";"105,83";"4203";"953";"81,52";3541059
"Presidente Alves";"2020";"4020";"1990";"2030";"98,03";"3537";"483";"87,99";3541109
"Presidente Bernardes";"2020";"13720";"6693";"7027";"95,25";"11480";"2240";"83,67";3541208
"Presidente Epitácio";"2020";"42400";"20622";"21778";"94,69";"39839";"2561";"93,96";3541307
"Presidente Prudente";"2020";"221073";"106275";"114798";"92,58";"216563";"4510";"97,96";3541406
"Presidente Venceslau";"2020";"38005";"18945";"19060";"99,4";"36873";"1132";"97,02";3541505
"Promissão";"2020";"39667";"19617";"20050";"97,84";"34106";"5561";"85,98";3541604
"Quadra";"2020";"3708";"1924";"1784";"107,85";"960";"2748";"25,89";3541653
"Quatá";"2020";"13935";"6931";"7004";"98,96";"13234";"701";"94,97";3541703
"Queiroz";"2020";"3279";"1666";"1613";"103,29";"2949";"330";"89,94";3541802
"Queluz";"2020";"12644";"6423";"6221";"103,25";"10370";"2274";"82,02";3541901
"Quintana";"2020";"6500";"3202";"3298";"97,09";"6009";"491";"92,45";3542008
"Rafard";"2020";"8976";"4430";"4546";"97,45";"8089";"887";"90,12";3542107
"Rancharia";"2020";"28847";"14110";"14737";"95,75";"26488";"2359";"91,82";3542206
"Redenção da Serra";"2020";"3837";"1977";"1860";"106,29";"2773";"1064";"72,27";3542305
"Regente Feijó";"2020";"19491";"9614";"9877";"97,34";"18302";"1189";"93,9";3542404
"Reginópolis";"2020";"7215";"4588";"2627";"174,65";"4298";"2917";"59,57";3542503
"Registro";"2020";"54216";"26535";"27681";"95,86";"48129";"6087";"88,77";3542602
"Restinga";"2020";"7493";"3742";"3751";"99,76";"6176";"1317";"82,42";3542701
"Ribeira";"2020";"3242";"1649";"1593";"103,52";"1483";"1759";"45,74";3542800
"Ribeirão Bonito";"2020";"12959";"6486";"6473";"100,2";"12265";"694";"94,64";3542909
"Ribeirão Branco";"2020";"17685";"9056";"8629";"104,95";"10493";"7192";"59,33";3543006
"Ribeirão Corrente";"2020";"4664";"2390";"2274";"105,1";"3860";"804";"82,76";3543105
"Ribeirão do Sul";"2020";"4360";"2169";"2191";"99";"3572";"788";"81,93";3543204
"Ribeirão dos Índios";"2020";"2141";"1053";"1088";"96,78";"1897";"244";"88,6";3543238
"Ribeirão Grande";"2020";"7510";"3790";"3720";"101,88";"2381";"5129";"31,7";3543253
"Ribeirão Pires";"2020";"118968";"58158";"60810";"95,64";"118968";"-";"100";3543303
"Ribeirão Preto";"2020";"683777";"328906";"354871";"92,68";"681837";"1940";"99,72";3543402
"Rifaina";"2020";"3468";"1731";"1737";"99,65";"3078";"390";"88,75";3543600
"Rincão";"2020";"10496";"5257";"5239";"100,34";"8655";"1841";"82,46";3543709
"Rinópolis";"2020";"9720";"4881";"4839";"100,87";"8910";"810";"91,67";3543808
"Rio Claro";"2020";"201212";"97853";"103359";"94,67";"196819";"4393";"97,82";3543907
"Rio das Pedras";"2020";"34416";"17336";"17080";"101,5";"33676";"740";"97,85";3544004
"Rio Grande da Serra";"2020";"49816";"24582";"25234";"97,42";"49816";"-";"100";3544103
"Riolândia";"2020";"11431";"6418";"5013";"128,03";"9043";"2388";"79,11";3544202
"Riversul";"2020";"5705";"2796";"2909";"96,12";"4307";"1398";"75,5";3543501
"Rosana";"2020";"18387";"9038";"9349";"96,67";"17719";"668";"96,37";3544251
"Roseira";"2020";"10642";"5351";"5291";"101,13";"10216";"426";"96";3544301
"Rubiácea";"2020";"3106";"1566";"1540";"101,69";"1871";"1235";"60,24";3544400
"Rubinéia";"2020";"2989";"1463";"1526";"95,87";"2621";"368";"87,69";3544509
"Sabino";"2020";"5468";"2717";"2751";"98,76";"4991";"477";"91,28";3544608
"Sagres";"2020";"2362";"1166";"1196";"97,49";"1989";"373";"84,21";3544707
"Sales";"2020";"6050";"3041";"3009";"101,06";"5631";"419";"93,07";3544806
"Sales Oliveira";"2020";"11518";"5687";"5831";"97,53";"10850";"668";"94,2";3544905
"Salesópolis";"2020";"16838";"8411";"8427";"99,81";"11173";"5665";"66,36";3545001
"Salmourão";"2020";"5117";"2606";"2511";"103,78";"4818";"299";"94,16";3545100
"Saltinho";"2020";"7860";"3886";"3974";"97,79";"6594";"1266";"83,89";3545159
"Salto";"2020";"115372";"56888";"58484";"97,27";"114561";"811";"99,3";3545209
"Salto de Pirapora";"2020";"44223";"21883";"22340";"97,95";"34810";"9413";"78,71";3545308
"Salto Grande";"2020";"9095";"4483";"4612";"97,2";"8380";"715";"92,14";3545407
"Sandovalina";"2020";"4211";"2130";"2081";"102,35";"3371";"840";"80,05";3545506
"Santa Adélia";"2020";"14892";"7442";"7450";"99,89";"14089";"803";"94,61";3545605
"Santa Albertina";"2020";"5672";"2845";"2827";"100,64";"5057";"615";"89,16";3545704
"Santa Bárbara d'Oeste";"2020";"188745";"93233";"95512";"97,61";"187263";"1482";"99,21";3545803
"Santa Branca";"2020";"14179";"7028";"7151";"98,28";"12507";"1672";"88,21";3546009
"Santa Clara d'Oeste";"2020";"2006";"1028";"978";"105,11";"1614";"392";"80,46";3546108
"Santa Cruz da Conceição";"2020";"4349";"2136";"2213";"96,52";"3398";"951";"78,13";3546207
"Santa Cruz da Esperança";"2020";"2077";"1021";"1056";"96,69";"1429";"648";"68,8";3546256
"Santa Cruz das Palmeiras";"2020";"33729";"17048";"16681";"102,2";"32998";"731";"97,83";3546306
"Santa Cruz do Rio Pardo";"2020";"46110";"22516";"23594";"95,43";"43274";"2836";"93,85";3546405
"Santa Ernestina";"2020";"5525";"2829";"2696";"104,93";"5316";"209";"96,22";3546504
"Santa Fé do Sul";"2020";"30804";"14770";"16034";"92,12";"29591";"1213";"96,06";3546603
"Santa Gertrudes";"2020";"26189";"13197";"12992";"101,58";"25911";"278";"98,94";3546702
"Santa Isabel";"2020";"55086";"27364";"27722";"98,71";"44716";"10370";"81,17";3546801
"Santa Lúcia";"2020";"8562";"4254";"4308";"98,75";"8208";"354";"95,87";3546900
"Santa Maria da Serra";"2020";"6141";"3082";"3059";"100,75";"5583";"558";"90,91";3547007
"Santa Mercedes";"2020";"2813";"1393";"1420";"98,1";"2572";"241";"91,43";3547106
"Santa Rita d'Oeste";"2020";"2404";"1188";"1216";"97,7";"1895";"509";"78,83";3547403
"Santa Rita do Passa Quatro";"2020";"26385";"12757";"13628";"93,61";"24263";"2122";"91,96";3547502
"Santa Rosa de Viterbo";"2020";"25604";"12591";"13013";"96,76";"24636";"968";"96,22";3547601
"Santa Salete";"2020";"1440";"728";"712";"102,25";"1031";"409";"71,6";3547650
"Santana da Ponte Pensa";"2020";"1509";"760";"749";"101,47";"1116";"393";"73,96";3547205
"Santana de Parnaíba";"2020";"138132";"68057";"70075";"97,12";"138132";"-";"100";3547304
"Santo Anastácio";"2020";"20127";"9781";"10346";"94,54";"18977";"1150";"94,29";3547700
"Santo André";"2020";"693867";"333318";"360549";"92,45";"693867";"-";"100";3547809
"Santo Antônio da Alegria";"2020";"6637";"3391";"3246";"104,47";"4999";"1638";"75,32";3547908
"Santo Antônio de Posse";"2020";"22849";"11441";"11408";"100,29";"21842";"1007";"95,59";3548005
"Santo Antônio do Aracanguá";"2020";"8252";"4161";"4091";"101,71";"7174";"1078";"86,94";3548054
"Santo Antônio do Jardim";"2020";"5826";"2970";"2856";"103,99";"3806";"2020";"65,33";3548104
"Santo Antônio do Pinhal";"2020";"6628";"3304";"3324";"99,4";"4631";"1997";"69,87";3548203
"Santo Expedito";"2020";"2972";"1482";"1490";"99,46";"2774";"198";"93,34";3548302
"Santópolis do Aguapeí";"2020";"4668";"2351";"2317";"101,47";"4555";"113";"97,58";3548401
"Santos";"2020";"428703";"197843";"230860";"85,7";"428382";"321";"99,93";3548500
"São Bento do Sapucaí";"2020";"10530";"5258";"5272";"99,73";"5435";"5095";"51,61";3548609
"São Bernardo do Campo";"2020";"812086";"392552";"419534";"93,57";"799027";"13059";"98,39";3548708
"São Caetano do Sul";"2020";"151244";"70285";"80959";"86,82";"151244";"-";"100";3548807
"São Carlos";"2020";"242632";"118836";"123796";"95,99";"232915";"9717";"96";3548906
"São Francisco";"2020";"2677";"1328";"1349";"98,44";"2198";"479";"82,11";3549003
"São João da Boa Vista";"2020";"87340";"42294";"45046";"93,89";"85046";"2294";"97,37";3549102
"São João das Duas Pontes";"2020";"2476";"1218";"1258";"96,82";"1908";"568";"77,06";3549201
"São João de Iracema";"2020";"1850";"925";"925";"100";"1652";"198";"89,3";3549250
"São João do Pau d'Alho";"2020";"1985";"976";"1009";"96,73";"1716";"269";"86,45";3549300
"São Joaquim da Barra";"2020";"50274";"24580";"25694";"95,66";"49386";"888";"98,23";3549409
"São José da Bela Vista";"2020";"8727";"4440";"4287";"103,57";"7961";"766";"91,22";3549508
"São José do Barreiro";"2020";"4070";"2026";"2044";"99,12";"3217";"853";"79,04";3549607
"São José do Rio Pardo";"2020";"53206";"26094";"27112";"96,25";"49041";"4165";"92,17";3549706
"São José do Rio Preto";"2020";"447924";"215795";"232129";"92,96";"420750";"27174";"93,93";3549805
"São José dos Campos";"2020";"710654";"347392";"363262";"95,63";"696197";"14457";"97,97";3549904
"São Lourenço da Serra";"2020";"15579";"7820";"7759";"100,79";"14499";"1080";"93,07";3549953
"São Luiz do Paraitinga";"2020";"10569";"5352";"5217";"102,59";"6337";"4232";"59,96";3550001
"São Manuel";"2020";"39574";"19314";"20260";"95,33";"39042";"532";"98,66";3550100
"São Miguel Arcanjo";"2020";"32000";"16172";"15828";"102,17";"24583";"7417";"76,82";3550209
"São Paulo";"2020";"11869660";"5651451";"6218209";"90,89";"11762962";"106698";"99,1";3550308
"São Pedro";"2020";"34208";"16589";"17619";"94,15";"29769";"4439";"87,02";3550407
"São Pedro do Turvo";"2020";"7369";"3736";"3633";"102,84";"5739";"1630";"77,88";3550506
"São Roque";"2020";"87435";"42753";"44682";"95,68";"84550";"2885";"96,7";3550605
"São Sebastião";"2020";"87135";"43160";"43975";"98,15";"86153";"982";"98,87";3550704
"São Sebastião da Grama";"2020";"11936";"6076";"5860";"103,69";"8489";"3447";"71,12";3550803
"São Simão";"2020";"14847";"7298";"7549";"96,68";"13710";"1137";"92,34";3550902
"São Vicente";"2020";"357929";"172235";"185694";"92,75";"357253";"676";"99,81";3551009
"Sarapuí";"2020";"10110";"5072";"5038";"100,67";"8130";"1980";"80,42";3551108
"Sarutaiá";"2020";"3646";"1832";"1814";"100,99";"3149";"497";"86,37";3551207
"Sebastianópolis do Sul";"2020";"3293";"1647";"1646";"100,06";"2810";"483";"85,33";3551306
"Serra Azul";"2020";"12282";"7337";"4945";"148,37";"8748";"3534";"71,23";3551405
"Serra Negra";"2020";"27440";"13276";"14164";"93,73";"23897";"3543";"87,09";3551603
"Serrana";"2020";"44434";"22166";"22268";"99,54";"44183";"251";"99,44";3551504
"Sertãozinho";"2020";"122355";"60606";"61749";"98,15";"121772";"583";"99,52";3551702
"Sete Barras";"2020";"12628";"6376";"6252";"101,98";"9143";"3485";"72,4";3551801
"Severínia";"2020";"17126";"8802";"8324";"105,74";"16546";"580";"96,61";3551900
"Silveiras";"2020";"6204";"3114";"3090";"100,78";"3339";"2865";"53,82";3552007
"Socorro";"2020";"38783";"19178";"19605";"97,82";"27762";"11021";"71,58";3552106
"Sorocaba";"2020";"658547";"322056";"336491";"95,71";"651845";"6702";"98,98";3552205
"Sud Mennucci";"2020";"7713";"3861";"3852";"100,23";"6644";"1069";"86,14";3552304
"Sumaré";"2020";"283212";"140074";"143138";"97,86";"279878";"3334";"98,82";3552403
"Suzanápolis";"2020";"3947";"2008";"1939";"103,56";"2634";"1313";"66,73";3552551
"Suzano";"2020";"291002";"142429";"148573";"95,86";"280758";"10244";"96,48";3552502
"Tabapuã";"2020";"11892";"5953";"5939";"100,24";"11145";"747";"93,72";3552601
"Tabatinga";"2020";"15897";"8120";"7777";"104,41";"14361";"1536";"90,34";3552700
"Taboão da Serra";"2020";"283871";"136294";"147577";"92,35";"283871";"-";"100";3552809
"Taciba";"2020";"6054";"3006";"3048";"98,62";"5320";"734";"87,88";3552908
"Taguaí";"2020";"13319";"6615";"6704";"98,67";"9542";"3777";"71,64";3553005
"Taiaçu";"2020";"6037";"3010";"3027";"99,44";"5629";"408";"93,24";3553104
"Taiúva";"2020";"6278";"3594";"2684";"133,9";"5894";"384";"93,88";3553203
"Tambaú";"2020";"22803";"11283";"11520";"97,94";"20834";"1969";"91,37";3553302
"Tanabi";"2020";"25105";"12520";"12585";"99,48";"23378";"1727";"93,12";3553401
"Tapiraí";"2020";"7699";"3850";"3849";"100,03";"5785";"1914";"75,14";3553500
"Tapiratiba";"2020";"12610";"6193";"6417";"96,51";"11298";"1312";"89,6";3553609
"Taquaral";"2020";"2751";"1382";"1369";"100,95";"2660";"91";"96,69";3553658
"Taquaritinga";"2020";"54499";"26800";"27699";"96,75";"52424";"2075";"96,19";3553708
"Taquarituba";"2020";"23193";"11538";"11655";"99";"21137";"2056";"91,14";3553807
"Taquarivaí";"2020";"5746";"2866";"2880";"99,51";"3337";"2409";"58,08";3553856
"Tarabai";"2020";"7269";"3601";"3668";"98,17";"6834";"435";"94,02";3553906
"Tarumã";"2020";"14806";"7514";"7292";"103,04";"14093";"713";"95,18";3553955
"Tatuí";"2020";"120123";"59175";"60948";"97,09";"116699";"3424";"97,15";3554003
"Taubaté";"2020";"307361";"150507";"156854";"95,95";"301096";"6265";"97,96";3554102
"Tejupá";"2020";"4697";"2385";"2312";"103,16";"3593";"1104";"76,5";3554201
"Teodoro Sampaio";"2020";"22414";"11076";"11338";"97,69";"18533";"3881";"82,68";3554300
"Terra Roxa";"2020";"9121";"4589";"4532";"101,26";"8779";"342";"96,25";3554409
"Tietê";"2020";"41073";"20308";"20765";"97,8";"37528";"3545";"91,37";3554508
"Timburi";"2020";"2557";"1309";"1248";"104,89";"1996";"561";"78,06";3554607
"Torre de Pedra";"2020";"2320";"1206";"1114";"108,26";"1651";"669";"71,16";3554656
"Torrinha";"2020";"9713";"4847";"4866";"99,61";"8482";"1231";"87,33";3554706
"Trabiju";"2020";"1703";"841";"862";"97,56";"1595";"108";"93,66";3554755
"Tremembé";"2020";"45978";"23882";"22096";"108,08";"42766";"3212";"93,01";3554805
"Três Fronteiras";"2020";"5547";"2758";"2789";"98,89";"4908";"639";"88,48";3554904
"Tuiuti";"2020";"6557";"3296";"3261";"101,07";"3560";"2997";"54,29";3554953
"Tupã";"2020";"62843";"30304";"32539";"93,13";"60322";"2521";"95,99";3555000
"Tupi Paulista";"2020";"14878";"7686";"7192";"106,87";"11685";"3193";"78,54";3555109
"Turiúba";"2020";"1912";"979";"933";"104,93";"1618";"294";"84,62";3555208
"Turmalina";"2020";"1805";"882";"923";"95,56";"1373";"432";"76,07";3555307
"Ubarana";"2020";"6066";"3075";"2991";"102,81";"5608";"458";"92,45";3555356
"Ubatuba";"2020";"88916";"43854";"45062";"97,32";"86842";"2074";"97,67";3555406
"Ubirajara";"2020";"4663";"2397";"2266";"105,78";"3439";"1224";"73,75";3555505
"Uchoa";"2020";"9683";"4781";"4902";"97,53";"9082";"601";"93,79";3555604
"União Paulista";"2020";"1739";"899";"840";"107,02";"1399";"340";"80,45";3555703
"Urânia";"2020";"8611";"4259";"4352";"97,86";"7504";"1107";"87,14";3555802
"Uru";"2020";"1207";"611";"596";"102,52";"1132";"75";"93,79";3555901
"Urupês";"2020";"13164";"6498";"6666";"97,48";"12090";"1074";"91,84";3556008
"Valentim Gentil";"2020";"12770";"6382";"6388";"99,91";"11859";"911";"92,87";3556107
"Valinhos";"2020";"124742";"61300";"63442";"96,62";"119288";"5454";"95,63";3556206
"Valparaíso";"2020";"23988";"13051";"10937";"119,33";"23353";"635";"97,35";3556305
"Vargem";"2020";"10000";"5068";"4932";"102,76";"6290";"3710";"62,9";3556354
"Vargem Grande do Sul";"2020";"41501";"20494";"21007";"97,56";"39933";"1568";"96,22";3556404
"Vargem Grande Paulista";"2020";"52762";"26108";"26654";"97,95";"52762";"-";"100";3556453
"Várzea Paulista";"2020";"120535";"59859";"60676";"98,65";"120535";"-";"100";3556503
"Vera Cruz";"2020";"10524";"5146";"5378";"95,69";"9460";"1064";"89,89";3556602
"Vinhedo";"2020";"77521";"38238";"39283";"97,34";"75085";"2436";"96,86";3556701
"Viradouro";"2020";"18347";"9192";"9155";"100,4";"17810";"537";"97,07";3556800
"Vista Alegre do Alto";"2020";"8014";"4087";"3927";"104,07";"7594";"420";"94,76";3556909
"Vitória Brasil";"2020";"1760";"890";"870";"102,3";"1562";"198";"88,75";3556958
"Votorantim";"2020";"119824";"59303";"60521";"97,99";"115254";"4570";"96,19";3557006
"Votuporanga";"2020";"91760";"44664";"47096";"94,84";"89189";"2571";"97,2";3557105
"Zacarias";"2020";"2560";"1271";"1289";"98,6";"2183";"377";"85,27";3557154
